1111111111
1000000001
1010000001
1010000111
1011011001
1000000001
1000000001
1011110001
1000100001
1000100001
1010000001
1010000001
101000$001
1010000001
1111111111